#,#,#,#,#,#,.,#,.,.,.
#,.,#,.,.,#,.,#,#,#,#
#,.,#,.,.,.,.,.,.,#,#
#,.,#,.,.,#,#,#,#,#,#
#,.,.,#,.,.,.,.,.,.,#
#,.,.,.,#,.,#,#,.,.,#
#,.,.,.,.,#,.,.,.,.,#
#,.,.,.,.,#,.,.,.,.,#
#,.,.,.,.,.,.,.,.,.,#
#,#,#,#,#,#,#,#,#,.,#